NO ./Makefile
SO ./Makefile
WE ./Makefile
EA ./Makefile

F 220,100,255
C 225,30,0


        1111111111111111111111111
        1000000000110000000000001
        1011000001110000000000001
        1001000000000000000000001
        1111111111111111111111111
        1000000000110000000000001
        1011000001110000000000001
        100100000001000000W000001
111111111011000001110000000000001
100000000010000001111111111111101
100000000010000001000000000000001
100000000010000001000000000000001
100000000010000001000000000000001
100000000010000001111111111111111
100000000000000000000000000000001
100000000000000000000000000000001
100000000000000000000000000000001
100000000000000000000000000000001
111111111111111111111111111111111
