NO ./Makefile
SO ./Makefile
WE ./Makefile
EA ./Makefile

F 220,100,255
C 225,30,0


111111111111111111111111111111111
1       1000000000110000000000001
1       1011000001110111111111001
1       1001000000001         101
1       1111111111111         111
1       1000000000111         101
1       1011000001111         101
1       1001000000010111111111001
111111111011000000000000011100001
100000000010000001111111111111111
100000000010000001
100000000010000001
100000000110000001
100000001010000001111111111111111
100000010000000000000000000000001
1000010000111111110000000000N0001
10000000001       100000010000001
10000000001       100000000000001
11111111111       111111111111111
