NO ./Makefile
SO ./Makefile
WE ./Makefile
EA ./Makefile

F 220,100,255
C 225,30,0

0111111
1000001
1111101
101N001
1011101
1000001
1111111