NO ./assets/north.xpm
SO ./assets/south.xpm
WE ./assets/west.xpm
EA ./assets/east.xpm

F 0,128,255
C 0,128,255


11111111111
10000000001
10000S0000111111111
1000000000000000001
1111111111100000001
          100000001
          111111111
